1,1,1,1,1,1,1,1,1,0,0,0,0,0,0,0,0,0,0,0
1,1,7,1,1,1,6,1,1,0,0,0,0,0,0,0,0,0,0,0
1,1,1,1,1,1,1,1,1,0,0,0,0,0,0,0,0,0,0,0
0,0,0,0,0,0,0,0,0,0,0,0,0,0,0,0,0,0,0,0
0,0,0,0,0,0,0,0,0,0,0,0,0,5,0,0,0,0,0,0
0,0,0,0,5,0,0,0,0,0,5,5,5,5,5,5,0,0,0,0
0,0,0,0,0,0,0,0,0,0,0,0,0,0,0,0,0,0,0,0
2,2,2,2,2,2,2,2,0,5,0,2,2,2,2,2,2,2,2,2
4,4,4,4,4,4,4,4,0,0,0,4,4,4,4,4,4,4,4,4
4,4,4,4,4,4,4,4,0,0,0,4,4,4,4,4,4,4,4,4
4,4,4,4,4,4,4,4,0,0,0,4,4,4,4,4,4,4,4,4
3,3,3,3,3,3,3,3,0,0,0,3,3,3,3,3,3,3,3,3
0,0,0,0,0,0,0,0,0,0,5,0,0,0,0,0,0,0,0,0
0,0,0,0,0,5,0,0,0,0,0,0,0,0,5,0,0,0,0,0
0,0,0,5,0,5,0,0,0,0,0,0,0,0,0,0,0,0,0,0
0,0,0,5,0,0,0,0,0,0,0,0,0,0,0,0,0,0,0,0
0,0,0,0,0,0,0,0,0,0,0,0,0,1,1,0,0,0,0,0
0,0,0,5,0,5,0,0,0,0,0,0,1,1,1,1,1,1,1,1
0,0,0,0,0,0,0,0,0,0,0,0,1,1,7,6,1,1,1,1
0,0,0,0,0,0,0,0,0,0,0,0,1,1,1,1,1,1,1,1
